9 9
3
E..E...E.
......M..
..M......
....M.S..
.M.......
.........
.........
.........
.........
Easy
---
MSSM..SE.
EE....M.E
..M......
....M.E..
.M.......
.........
.........
.........
.........
Hard
---
E.SE.EMM.
..E...M..
..M......
....M.S..
.S.......
.........
.........
.........
.........
Medium
---
